#*+.NESW}][{9317

{NNNNNNNNNN}
W..........E
W..........E
W..........E
W..........E
W..........E
W..........E
W..........E
W..........E
W..........E
W..........E
[SSSSSSSSSS]

{NNN3..1NNN}
W..........E
W..........E
W..........E
W..........E
W..........E
W..........E
W..........E
W..........E
W..........E
W..........E
[SSSSSSSSSS]

{NNNNNNNNNN}
W..........E
W..........E
W..........E
W..........1
W...........
W...........
W..........7
W..........E
W..........E
W..........E
[SSSSSSSSSS]

{NNN3..1NNN}
W..........E
W..........E
W..........E
W..........1
W...........
W...........
W..........7
W..........E
W..........E
W..........E
[SSSSSSSSSS]

{NNNNNNNNNN}
W..........E
W..........E
W..........E
W..........E
W..........E
W..........E
W..........E
W..........E
W..........E
W..........E
[SSS9..7SSS]

{NNN3..1NNN}
W..........E
W..........E
W..........E
W..........E
W..........E
W..........E
W..........E
W..........E
W..........E
W..........E
[SSS9..7SSS]

{NNNNNNNNNN}
W..........E
W..........E
W..........E
W..........1
W...........
W...........
W..........7
W..........E
W..........E
W..........E
[SSS9..7SSS]

{NNN3..1NNN}
W..........E
W..........E
W..........E
W..........1
W...........
W...........
W..........7
W..........E
W..........E
W..........E
[SSS9..7SSS]

{NNNNNNNNNN}
W..........E
W..........E
W..........E
3..........E
...........E
...........E
9..........E
W..........E
W..........E
W..........E
[SSSSSSSSSS]

{NNN3..1NNN}
W..........E
W..........E
W..........E
3..........E
...........E
...........E
9..........E
W..........E
W..........E
W..........E
[SSSSSSSSSS]

{NNNNNNNNNN}
W..........E
W..........E
W..........E
3..........1
............
............
9..........7
W..........E
W..........E
W..........E
[SSSSSSSSSS]

{NNN3..1NNN}
W..........E
W..........E
W..........E
3..........1
............
............
9..........7
W..........E
W..........E
W..........E
[SSSSSSSSSS]

{NNNNNNNNNN}
W..........E
W..........E
W..........E
3..........E
...........E
...........E
9..........E
W..........E
W..........E
W..........E
[SSS9..7SSS]

{NNN3..1NNN}
W..........E
W..........E
W..........E
3..........E
...........E
...........E
9..........E
W..........E
W..........E
W..........E
[SSS9..7SSS]

{NNNNNNNNNN}
W..........E
W..........E
W..........E
3..........1
............
............
9..........7
W..........E
W..........E
W..........E
[SSS9..7SSS]

{NNN3..1NNN}
W..........E
W..........E
W..........E
3..........1
............
............
9..........7
W..........E
W..........E
W..........E
[SSS9..7SSS]
